love	אהבה	noun
life	חיים	noun
peace	שלום	noun
dream	חלום	noun
Moon	ירח	noun
Sun	שמש	noun
sky	שמים	noun
God	אלוהים	noun
song	שיר	noun
world	עולם	noun
word	מילה	noun
heart	לב	noun
rainbow	קשת	noun
water	מים	noun
fire	אש	noun
land	ערץ	noun
place	מקום	noun
work	עבודה	noun
home	בית	noun
Jew	יהודי	noun
Christian	נוצרי	noun
Muslim	מוסלמי	noun
man	איש	noun
woman	אישה	noun
father	אבא	noun
mother	אמא	noun
son	בן	noun
daughter	בת	noun
family	משפחה	noun
