love	אהבה	noun
life	חיים	noun
peace	שלום	noun
dream	חלום	noun
Moon	ירח	noun
Sun	שמש	noun
sky	שמים	noun
God	אלוהים	noun
song	שיר	noun
world	עולם	noun
word	מילה	noun
heart	לב	noun
day	יום	noun
night	לילה	noun
morning	בוקר	noun
evening	ערב	noun
rainbow	קשת	noun
water	מים	noun
fire	אש	noun
land	ערץ	noun
place	מקום	noun
time	זמן	noun
Israel	ישראל	noun
Palestine	פלסטין	noun	
Poland	פולין	noun
work	עבודה	noun
home	בית	noun
freedom	חופש	noun
Jew	יהודי	noun
Christian	נוצרי	noun
Muslim	מוסלמי	noun
luck	מזל	noun
happiness	שמחה	noun
beauty	יופי	noun
